NO ./bonus_files/textures/rca2.xpm 
F 10,20,2
C 13,169,169

WE ./bonus_files/textures/rca2.xpm
EA ./bonus_files/textures/rca2.xpm
S ./bonus_files/textures/rca2.xpm





11111111111111111	
1000000000000000011111
11111000000000000000011111
10000000000000000100000001
10000000000000001111111111
111100000000000000001			
1000000000N0000001001
100000000000000011111
1000000000000000011
111111111111111111
