N ../hh/./mandatory_files/textures/rca2.xpm

WE ./mandatory_files/textures/gb1.xpm




C 13,169,160

EA ./mandatory_files/textures/gb2.xpm

F 100,20, 88

S ./mandatory_files/textures/rca1.xpm


    11111111111111111	
    1000000000000000011111
11111000000000000000011111
10000000000000000100000001
10000000000000001111111111
111100000000000000001
100000000000000001001
10000000000000001111
1000000000N00000011
1111111D111111111011111111111111111111
1111111D11111111DDDDDDDDDDDDDDDDDD0001

10000000000000000111111111111111111111
1111111111111111111         
1111111111111111111    
111111111111111111
100000000000000111
1000000000000000011
1111111111111111111
    1111111111111111111

      