F 100,20,255
C 13,169,160
NO ./bonus_files/textures/rca2.xpm

WE ./bonus_files/textures/gb1.xpm





EA ./bonus_files/textures/gb2.xpm


S ./bonus_files/textures/rca1.xpm



    11111111111111111	
    1000000000000000011111
11111000000000000000011111
1000000000000000100000001
10000000000000001111111111
111100000000D00000001			
100000000000000001001
10000000000000001111
1000000000N00000011
1111111111111111011111111111111111111
1111111111111110001
10000000000000000111111111111111111111
1111111111111111111  
1111111111111111111   
111111111111111111
100000000000000111
1000000000000000011
1111111111111111111
    1111111111111111111

