N ./textures/rca2.xpm
WE ./textures/gb1.xpm
C 169,169,169
EA ./textures/gb2.xpm
F 100, 20, 88
S ./textures/rca1.xpm

    111111111111111111
    100000000000000001
1111100000000000000001
100000000000000001111
100000000000000001
100000000000000001
100000000000000001
111111111D11111111
100000000000000001
100000000N00000001
111111111111111111