N ./textures/rca2.xpm
WE ./textures/gb1.xpm
C 169,169,169
EA ./textures/gb2.xpm
F 100, 20, 88
S ./textures/rca1.xpm

    11111111111111111
    100000000000000001111
111110000000000000000   1
100000000000000001000    1
10D0000000000000111111111
1000000000N00000011
1000000000000000011
111111111D111111111
10000000000000011
1000000000000000011
1111111111111111111