N ./textures/rca2.xpm
WE ./textures/gb1.xpm
C 169,169,169
EA ./textures/gb2.xpm
F 100, 20, 88
S ./textures/rca1.xpm

    111111111111111111
    100000000000000001
1111100000000000000001
100000000000000001111
10D000000000000011
1000000000000000011
1000000000000000011
1111111110111111111
10000000000000011
10000N0000000000011
1111111111111111111