N ./textures/bluestone.xpm
WE ./textures/gb1.xpm
C 169,169,169
EA ./textures/gb2.xpm
F 100, 20, 88
S ./textures/gb1.xpm

111111111111111111
1000000000000S0001
100000000000000001
100000000000000001
10000D000000000001
100000000000000001
100000000000000001
100000000000000001
100000000000000001
100000000000000001
111111111111111111