N ./text.xpm
F 2,2,2
WE ./text.xpm
C 0,0,0
EA ./text.xpm
S ./text.xpm

111111111111111111
1000010000000N0001
100001000000000001
100001000000000001
10000D000000000001
100001000000000001
100001000000000001
100001000000000001
100001000000000001
100001000000000001
111111111111111111