N ./text.xpm

WE ./text.xpm
C 0,0,0
EA ./text.xpm
S ./text.xpm

111111111111111111
100001000000000001
100001000000000001
100001000000000001
100001000000000001
100001000E00000001
100001000000000001
100001000000000001
100001000000000001
10000D000000000001
111111111111111111