C 169,169,169
F 100, 20, 88
N ./mandatory_files/textures/rca2.xpm
S ./mandatory_files/textures/rca1.xpm
WE ./mandatory_files/textures/gb1.xpm
EA ./mandatory_files/textures/gb2.xpm
        

1111111111111111111111111111
11111000000000110000000000001
1011000001110000000000001111
100100000000000000000000111111111
111111111011000001110000000000001
100000000011000001110111111111111
11111111111111111111111111
11111111111111111111111111111
11111111111111111111111111111
1111011111111101110000000001
11110111111111011101010010001
11000000110101011100000010001
10000000000000001100000010001
10000000000000001101010010001
11000001110101011111011110N0111
11110111 1110101 101111010001
11111111 1111111 111111111111




