N ./textures/rca2.xpm
WE ./textures/gb1.xpm
C 169,169,169
EA ./textures/gb2.xpm
F 100, 20, 88
S ./textures/rca1.xpm

    11111111111111111
    100000000000000001111
1111100000000000000001
1000000000000000010001
10D000000000000011111
1000000000N00000011
1000000000000000011
111111111D111111111
10000000000000011
1000000000000000011
1111111111111111111