C 169,169,169
F 100 , 20,  88
N  textures/rca2.xpm 
S ./textures/rca1.xpm
WE ./textures/gb1.xpm
EA ./textures/gb2.xpm

111111111111
10E000100001
111010101011
100010001011
111111111111
     
    
     
