N ./text.xpm
WE ./text.xpm
C 169,169,169
EA ./text.xpm
F 135,206,235
S ./text.xpm

111111111111111111
1000010000000S0001
100001000000000001
100001000000000001
10000D000000000001
100001000000000001
100001000000000001
100001000000000001
100001000000000001
100001000000000001
111111111111111111