C 169,169,169
F 100, 20, 88
N  textures/rca2.xpm
S ./textures/rca1.xpm
WE ./textures/gb1.xpm
EA ./textures/gb2.xpm

11111111111111111111111111111111111111111
10E00010001000001000000010000000001010001
11101010101011101011101110111011101011101
10001000101010101000100000101010000000001
10101110111110101111111010101110111111111
10101010100000000010000010100010100010001
10111011111111111010111110101111111010101
11111111111111111111111111111111111111111